//MAP CONVERTED BY dmm2tgm.py THIS HEADER COMMENT PREVENTS RECONVERSION, DO NOT REMOVE
"aV" = (
/obj/structure/railing{
	color = "#8a7453";
	dir = 8
	},
/obj/machinery/hydroponics/soil,
/turf/open/misc/asteroid/snow/icemoon,
/area/icemoon/surface/outdoors/nospawn)
"cP" = (
/mob/living/simple_animal/hostile/asteroid/polarbear,
/turf/open/floor/wood/large{
	initial_gas_mix = "ICEMOON_ATMOS"
	},
/area/ruin/powered/shuttle)
"dZ" = (
/obj/structure/railing{
	color = "#8a7453"
	},
/obj/structure/flora/tree/pine/style_random,
/turf/open/misc/asteroid/snow/icemoon,
/area/icemoon/surface/outdoors/nospawn)
"fd" = (
/obj/structure/table/bronze{
	color = "#666666"
	},
/obj/structure/sink/kitchen/directional/south,
/obj/item/plate,
/turf/open/floor/wood/large{
	initial_gas_mix = "ICEMOON_ATMOS"
	},
/area/ruin/powered/shuttle)
"fJ" = (
/obj/structure/railing{
	color = "#8a7453"
	},
/obj/machinery/hydroponics/soil,
/turf/open/misc/asteroid/snow/icemoon,
/area/icemoon/surface/outdoors/nospawn)
"kC" = (
/obj/item/grown/log,
/obj/item/grown/log{
	pixel_y = 13
	},
/turf/open/misc/asteroid/snow/icemoon,
/area/icemoon/surface/outdoors/nospawn)
"mw" = (
/obj/machinery/hydroponics/soil,
/turf/open/floor/plating/snowed/smoothed/icemoon,
/area/icemoon/surface/outdoors/nospawn)
"ng" = (
/turf/open/floor/wood/large{
	initial_gas_mix = "ICEMOON_ATMOS"
	},
/area/ruin/powered/shuttle)
"nL" = (
/obj/structure/fluff/fokoff_sign{
	name = "Homestead Sign";
	pixel_y = 7
	},
/turf/open/misc/asteroid/snow/icemoon,
/area/icemoon/surface/outdoors/nospawn)
"ol" = (
/turf/closed/wall/mineral/wood,
/area/ruin/powered/shuttle)
"pH" = (
/obj/structure/railing{
	color = "#8a7453"
	},
/obj/machinery/hydroponics/soil,
/turf/open/floor/plating/snowed/smoothed/icemoon,
/area/icemoon/surface/outdoors/nospawn)
"pU" = (
/obj/effect/turf_decal/siding/wood{
	dir = 8
	},
/turf/open/floor/wood/large{
	initial_gas_mix = "ICEMOON_ATMOS"
	},
/area/ruin/powered/shuttle)
"qw" = (
/obj/structure/railing{
	color = "#8a7453";
	dir = 4
	},
/turf/open/misc/asteroid/snow/icemoon,
/area/icemoon/surface/outdoors/nospawn)
"rg" = (
/obj/machinery/hydroponics/soil,
/turf/open/misc/asteroid/snow/icemoon,
/area/icemoon/surface/outdoors/nospawn)
"su" = (
/turf/open/openspace/icemoon/keep_below,
/area/icemoon/surface/outdoors/nospawn)
"un" = (
/turf/open/floor/plating/snowed/smoothed/icemoon,
/area/icemoon/surface/outdoors/nospawn)
"uH" = (
/obj/structure/closet/cabinet,
/obj/item/restraints/legcuffs/beartrap,
/obj/item/restraints/legcuffs/beartrap,
/obj/item/ammo_casing/shotgun/buckshot,
/obj/item/ammo_casing/shotgun/buckshot,
/obj/item/ammo_casing/shotgun/buckshot,
/turf/open/floor/wood/large{
	initial_gas_mix = "ICEMOON_ATMOS"
	},
/area/ruin/powered/shuttle)
"vI" = (
/obj/effect/turf_decal/siding/wood{
	dir = 8
	},
/obj/structure/table/wood,
/obj/item/candle{
	pixel_x = -8;
	pixel_y = 13
	},
/obj/item/food/soup/stew{
	name = "porridge";
	pixel_y = 3
	},
/turf/open/floor/wood/large{
	initial_gas_mix = "ICEMOON_ATMOS"
	},
/area/ruin/powered/shuttle)
"wl" = (
/obj/effect/turf_decal/siding/wood{
	dir = 1
	},
/obj/effect/turf_decal/siding/wood,
/obj/structure/mineral_door/wood,
/turf/open/floor/stone{
	initial_gas_mix = "ICEMOON_ATMOS"
	},
/area/ruin/powered/shuttle)
"wN" = (
/turf/open/openspace/icemoon/keep_below,
/area/ruin/powered/shuttle)
"ym" = (
/obj/structure/chair/wood{
	dir = 4
	},
/turf/open/floor/stone{
	initial_gas_mix = "ICEMOON_ATMOS"
	},
/area/ruin/powered/shuttle)
"yR" = (
/obj/item/grown/log{
	pixel_y = -6
	},
/obj/item/grown/log{
	pixel_y = 6
	},
/turf/open/misc/asteroid/snow/icemoon,
/area/icemoon/surface/outdoors/nospawn)
"zT" = (
/obj/structure/bed/dogbed,
/turf/open/floor/wood/large{
	initial_gas_mix = "ICEMOON_ATMOS"
	},
/area/ruin/powered/shuttle)
"Bl" = (
/obj/structure/railing{
	color = "#8a7453";
	dir = 10
	},
/obj/machinery/hydroponics/soil,
/turf/open/floor/plating/snowed/smoothed/icemoon,
/area/icemoon/surface/outdoors/nospawn)
"Cv" = (
/obj/structure/bookcase/random/religion,
/turf/open/floor/stone{
	initial_gas_mix = "ICEMOON_ATMOS"
	},
/area/ruin/powered/shuttle)
"El" = (
/obj/structure/table{
	color = "#f2ffbd"
	},
/obj/item/flashlight/lantern,
/turf/open/floor/wood/large{
	initial_gas_mix = "ICEMOON_ATMOS"
	},
/area/ruin/powered/shuttle)
"Fd" = (
/obj/structure/railing{
	color = "#8a7453";
	dir = 1
	},
/obj/item/reagent_containers/cup/bucket/wooden,
/turf/open/misc/asteroid/snow/icemoon,
/area/icemoon/surface/outdoors/nospawn)
"Hv" = (
/obj/structure/chair/wood{
	dir = 8
	},
/turf/open/floor/wood/large{
	initial_gas_mix = "ICEMOON_ATMOS"
	},
/area/ruin/powered/shuttle)
"Hy" = (
/obj/structure/barricade/wooden/crude/snow,
/obj/effect/mapping_helpers/broken_floor,
/turf/open/floor/wood{
	initial_gas_mix = "ICEMOON_ATMOS"
	},
/area/ruin/powered/shuttle)
"HF" = (
/obj/effect/decal/cleanable/blood/gibs,
/obj/effect/decal/cleanable/blood/innards,
/obj/effect/decal/cleanable/blood/gibs/up,
/obj/effect/decal/cleanable/blood/gibs/limb{
	pixel_x = -9;
	pixel_y = -8
	},
/turf/open/floor/stone{
	initial_gas_mix = "ICEMOON_ATMOS"
	},
/area/ruin/powered/shuttle)
"Il" = (
/obj/structure/flora/tree/dead/style_random,
/turf/open/misc/asteroid/snow/icemoon,
/area/icemoon/surface/outdoors/nospawn)
"Iz" = (
/obj/structure/fireplace{
	pixel_x = -21
	},
/obj/item/stack/sheet/animalhide/generic{
	pixel_x = -5;
	pixel_y = -7
	},
/turf/open/floor/stone{
	initial_gas_mix = "ICEMOON_ATMOS"
	},
/area/ruin/powered/shuttle)
"JB" = (
/obj/structure/flora/rock/pile/icy/style_random,
/turf/open/misc/asteroid/snow/icemoon,
/area/icemoon/surface/outdoors/nospawn)
"JJ" = (
/turf/open/misc/asteroid/snow/icemoon,
/area/icemoon/surface/outdoors/nospawn)
"Mq" = (
/obj/structure/flora/rock/icy/style_random,
/turf/open/misc/asteroid/snow/icemoon,
/area/icemoon/surface/outdoors/nospawn)
"Nz" = (
/obj/structure/bed,
/obj/item/bedsheet/patriot,
/turf/open/floor/wood/large{
	initial_gas_mix = "ICEMOON_ATMOS"
	},
/area/ruin/powered/shuttle)
"NP" = (
/obj/item/wallframe/picture,
/turf/closed/wall/mineral/wood,
/area/ruin/powered/shuttle)
"NT" = (
/obj/structure/bonfire,
/turf/open/misc/asteroid/snow/icemoon,
/area/icemoon/surface/outdoors/nospawn)
"Oa" = (
/obj/structure/railing{
	color = "#8a7453"
	},
/turf/open/misc/asteroid/snow/icemoon,
/area/icemoon/surface/outdoors/nospawn)
"Of" = (
/obj/structure/closet/cabinet{
	name = "Pantry"
	},
/obj/item/food/grown/potato,
/obj/item/food/grown/potato,
/obj/item/food/grown/potato/sweet,
/obj/item/food/grown/potato/sweet,
/obj/item/seeds/coffee,
/obj/item/seeds/coffee,
/turf/open/floor/wood/large{
	initial_gas_mix = "ICEMOON_ATMOS"
	},
/area/ruin/powered/shuttle)
"OX" = (
/obj/structure/table/wood{
	pixel_x = -3;
	pixel_y = 3
	},
/obj/item/storage/book/bible{
	pixel_y = 5
	},
/obj/item/candle{
	pixel_x = -10;
	pixel_y = 5
	},
/turf/open/floor/stone{
	initial_gas_mix = "ICEMOON_ATMOS"
	},
/area/ruin/powered/shuttle)
"Qi" = (
/obj/structure/table/bronze{
	color = "#666666"
	},
/obj/item/knife/hunting,
/obj/item/reagent_containers/cup/glass/mug/coco{
	desc = "Still hot!";
	pixel_x = 6;
	pixel_y = 11
	},
/turf/open/floor/wood/large{
	initial_gas_mix = "ICEMOON_ATMOS"
	},
/area/ruin/powered/shuttle)
"QI" = (
/turf/open/floor/stone{
	initial_gas_mix = "ICEMOON_ATMOS"
	},
/area/ruin/powered/shuttle)
"RO" = (
/obj/effect/turf_decal/siding/wood,
/obj/effect/turf_decal/siding/wood{
	dir = 1
	},
/obj/structure/mineral_door/wood,
/obj/item/assembly/mousetrap/armed,
/turf/open/floor/wood/large{
	initial_gas_mix = "ICEMOON_ATMOS"
	},
/area/ruin/powered/shuttle)
"Sv" = (
/turf/open/genturf,
/area/icemoon/underground/unexplored/rivers)
"TS" = (
/obj/structure/railing{
	color = "#8a7453";
	dir = 8
	},
/obj/machinery/hydroponics/soil,
/turf/open/floor/plating/snowed/smoothed/icemoon,
/area/icemoon/surface/outdoors/nospawn)
"Ua" = (
/mob/living/simple_animal/hostile/tree,
/turf/open/misc/asteroid/snow/icemoon,
/area/icemoon/surface/outdoors/nospawn)
"Vf" = (
/obj/structure/barricade/wooden/snowed,
/obj/effect/mapping_helpers/broken_floor,
/turf/open/floor/wood{
	initial_gas_mix = "ICEMOON_ATMOS"
	},
/area/ruin/powered/shuttle)
"XZ" = (
/obj/structure/toilet{
	dir = 8
	},
/turf/open/floor/stone{
	initial_gas_mix = "ICEMOON_ATMOS"
	},
/area/ruin/powered/shuttle)
"Yb" = (
/obj/item/grown/log,
/obj/item/grown/log,
/obj/item/grown/log,
/obj/item/hatchet/wooden{
	pixel_y = -19
	},
/turf/open/misc/asteroid/snow/icemoon,
/area/icemoon/surface/outdoors/nospawn)
"Zg" = (
/obj/effect/turf_decal/siding/wood,
/obj/effect/turf_decal/siding/wood{
	dir = 1
	},
/obj/structure/mineral_door/wood,
/turf/open/floor/wood/large{
	initial_gas_mix = "ICEMOON_ATMOS"
	},
/area/ruin/powered/shuttle)

(1,1,1) = {"
Sv
Sv
Sv
Sv
Sv
Sv
Sv
Sv
Sv
Sv
Sv
Sv
Sv
Sv
Sv
Sv
Sv
Sv
Sv
Sv
Sv
"}
(2,1,1) = {"
Sv
Sv
Sv
Sv
Sv
Sv
Sv
Sv
Sv
ol
ol
ol
Hy
ol
TS
TS
aV
Bl
Ua
Sv
Sv
"}
(3,1,1) = {"
Sv
Sv
Sv
Sv
Sv
Sv
ol
ol
ol
NP
OX
Cv
Cv
ol
un
JJ
un
JJ
JJ
JJ
Sv
"}
(4,1,1) = {"
Sv
su
Sv
Sv
Ua
JJ
Vf
El
zT
ol
Iz
QI
QI
wl
JJ
un
JJ
JJ
JJ
JJ
Sv
"}
(5,1,1) = {"
Sv
Sv
su
su
su
JJ
ol
Nz
ng
RO
HF
ym
QI
wl
JJ
JJ
JJ
Oa
nL
JJ
Sv
"}
(6,1,1) = {"
Sv
Sv
Sv
su
su
su
ol
uH
ng
ol
pU
vI
pU
ol
JJ
rg
rg
pH
JJ
JB
Sv
"}
(7,1,1) = {"
Sv
Sv
Sv
Sv
su
su
ol
ol
ol
ol
cP
Hv
ng
Vf
un
rg
rg
fJ
Il
JJ
Sv
"}
(8,1,1) = {"
Sv
Sv
Sv
Sv
su
su
su
Hy
wN
Zg
ng
ng
ng
ol
JJ
un
JJ
JJ
JJ
JJ
Sv
"}
(9,1,1) = {"
Sv
Sv
Sv
Sv
JJ
JJ
JJ
ol
XZ
ol
fd
Qi
Of
ol
JJ
rg
rg
rg
JJ
Sv
Sv
"}
(10,1,1) = {"
Sv
Sv
Sv
Sv
Sv
NT
JJ
ol
ol
ol
Vf
ol
ol
ol
JJ
mw
rg
fJ
Sv
Sv
Sv
"}
(11,1,1) = {"
Sv
Sv
Sv
Sv
Sv
JJ
JJ
dZ
Yb
yR
kC
Fd
Il
JJ
JJ
JJ
JJ
JJ
Sv
Sv
Sv
"}
(12,1,1) = {"
Sv
Sv
Sv
Sv
Sv
Sv
Mq
JJ
JJ
JJ
JJ
JJ
qw
qw
qw
JJ
Sv
Sv
Sv
Sv
Sv
"}
(13,1,1) = {"
Sv
Sv
Sv
Sv
Sv
Sv
Sv
Sv
Sv
Sv
Sv
Sv
Sv
Sv
Sv
Sv
Sv
Sv
Sv
Sv
Sv
"}
