//MAP CONVERTED BY dmm2tgm.py THIS HEADER COMMENT PREVENTS RECONVERSION, DO NOT REMOVE
"aa" = (
/turf/template_noop,
/area/template_noop)
"ab" = (
/turf/closed/mineral/random,
/area/ruin/unpowered/no_grav)
"ac" = (
/turf/open/misc/asteroid/airless,
/area/ruin/unpowered/no_grav)
"ad" = (
/turf/closed/wall,
/area/ruin/unpowered/no_grav)
"ae" = (
/turf/closed/wall/rust,
/area/ruin/unpowered/no_grav)
"af" = (
/obj/item/stack/rods{
	amount = 2
	},
/obj/item/shard,
/turf/open/misc/asteroid/airless,
/area/ruin/unpowered/no_grav)
"ag" = (
/obj/effect/spawner/structure/window,
/turf/open/floor/plating,
/area/ruin/unpowered/no_grav)
"ah" = (
/obj/structure/grille/broken,
/obj/structure/barricade/wooden/crude,
/obj/structure/trap/cult,
/obj/effect/decal/cleanable/glass,
/turf/open/floor/plating/airless,
/area/ruin/unpowered/no_grav)
"ai" = (
/obj/structure/light_prism,
/turf/open/floor/iron/dark/airless,
/area/ruin/unpowered/no_grav)
"aj" = (
/obj/effect/decal/cleanable/blood/drip,
/turf/open/floor/plating/airless,
/area/ruin/unpowered/no_grav)
"ak" = (
/obj/item/ectoplasm,
/turf/open/misc/asteroid/airless,
/area/ruin/unpowered/no_grav)
"al" = (
/obj/structure/closet/crate/coffin,
/turf/open/floor/iron/dark/airless,
/area/ruin/unpowered/no_grav)
"am" = (
/turf/open/floor/plating/airless,
/area/ruin/unpowered/no_grav)
"an" = (
/turf/open/floor/carpet/royalblack/airless,
/area/ruin/unpowered/no_grav)
"ao" = (
/obj/structure/table/wood/fancy,
/obj/item/reagent_containers/cup/glass/bottle/holywater,
/turf/open/floor/carpet/airless,
/area/ruin/unpowered/no_grav)
"ap" = (
/obj/structure/table/wood/fancy,
/obj/item/melee/cleric_mace,
/turf/open/floor/carpet/airless,
/area/ruin/unpowered/no_grav)
"aq" = (
/obj/effect/decal/cleanable/shreds,
/turf/open/floor/carpet/airless,
/area/ruin/unpowered/no_grav)
"ar" = (
/obj/effect/decal/cleanable/shreds,
/obj/effect/decal/remains/human,
/obj/item/disk/design_disk/adv/cleric_mace,
/obj/structure/trap/cult,
/turf/open/floor/carpet/airless,
/area/ruin/unpowered/no_grav)
"as" = (
/obj/effect/decal/cleanable/shreds,
/turf/open/floor/carpet/royalblack/airless,
/area/ruin/unpowered/no_grav)
"at" = (
/turf/open/floor/carpet/royalblue/airless,
/area/ruin/unpowered/no_grav)
"au" = (
/turf/open/floor/carpet/airless,
/area/ruin/unpowered/no_grav)
"av" = (
/obj/effect/decal/cleanable/blood/splatter,
/obj/effect/decal/cleanable/blood/footprints,
/obj/effect/decal/cleanable/shreds,
/turf/open/floor/carpet/airless,
/area/ruin/unpowered/no_grav)
"aw" = (
/obj/effect/decal/cleanable/blood/drip,
/turf/open/floor/carpet/royalblack/airless,
/area/ruin/unpowered/no_grav)
"ax" = (
/obj/structure/bonfire,
/turf/open/floor/iron/dark/airless,
/area/ruin/unpowered/no_grav)
"ay" = (
/obj/effect/decal/cleanable/blood/tracks,
/turf/open/floor/carpet/airless,
/area/ruin/unpowered/no_grav)
"az" = (
/obj/item/paper/fluff/ruins/clericsden/contact,
/turf/open/floor/plating/airless,
/area/ruin/unpowered/no_grav)
"aA" = (
/obj/structure/table/wood{
	layer = 3.3
	},
/turf/open/floor/carpet/royalblack/airless,
/area/ruin/unpowered/no_grav)
"aB" = (
/obj/effect/decal/cleanable/blood/footprints,
/obj/effect/decal/cleanable/blood/tracks,
/turf/open/floor/carpet/airless,
/area/ruin/unpowered/no_grav)
"aC" = (
/obj/structure/chair/wood{
	dir = 1
	},
/turf/open/floor/carpet/royalblue/airless,
/area/ruin/unpowered/no_grav)
"aD" = (
/obj/effect/decal/remains/human,
/obj/structure/trap/cult,
/turf/open/floor/carpet/airless,
/area/ruin/unpowered/no_grav)
"aE" = (
/obj/effect/decal/cleanable/blood/tracks,
/mob/living/simple_animal/hostile/construct/proteon/hostile,
/turf/open/floor/carpet/airless,
/area/ruin/unpowered/no_grav)
"aF" = (
/obj/item/flashlight/flare/torch,
/turf/open/floor/plating/airless,
/area/ruin/unpowered/no_grav)
"aG" = (
/obj/effect/decal/cleanable/blood/tracks,
/obj/structure/trap/cult,
/turf/open/floor/carpet/airless,
/area/ruin/unpowered/no_grav)
"aH" = (
/obj/structure/light_prism,
/turf/open/floor/plating/airless,
/area/ruin/unpowered/no_grav)
"aI" = (
/obj/effect/decal/cleanable/blood/drip,
/turf/open/floor/carpet/airless,
/area/ruin/unpowered/no_grav)
"aJ" = (
/obj/structure/rack,
/obj/item/tank/internals/emergency_oxygen,
/obj/item/clothing/mask/breath,
/turf/open/floor/iron/dark/airless,
/area/ruin/unpowered/no_grav)
"aK" = (
/obj/effect/spawner/structure/window,
/turf/open/floor/plating/airless,
/area/ruin/unpowered/no_grav)
"aL" = (
/obj/machinery/door/airlock/wood,
/turf/open/floor/plating/airless,
/area/ruin/unpowered/no_grav)
"aM" = (
/obj/effect/decal/cleanable/blood/tracks,
/obj/machinery/door/airlock/wood,
/turf/open/floor/plating/airless,
/area/ruin/unpowered/no_grav)
"aN" = (
/mob/living/simple_animal/hostile/construct/proteon,
/turf/open/misc/asteroid/airless,
/area/ruin/unpowered/no_grav)
"aO" = (
/obj/effect/spawner/structure/window,
/obj/structure/barricade/wooden/crude,
/turf/open/floor/plating/airless,
/area/ruin/unpowered/no_grav)
"aP" = (
/obj/machinery/door/airlock/wood,
/turf/open/floor/plating/airless,
/area/ruin/space)
"aQ" = (
/obj/item/storage/book/bible,
/obj/effect/decal/cleanable/blood,
/turf/open/misc/asteroid/airless,
/area/ruin/unpowered/no_grav)
"aR" = (
/obj/structure/closet/crate/coffin,
/obj/item/gps/spaceruin,
/turf/open/floor/iron/dark/airless,
/area/ruin/unpowered/no_grav)
"aS" = (
/obj/effect/decal/cleanable/blood/drip,
/turf/open/misc/asteroid/airless,
/area/ruin/unpowered/no_grav)
"aT" = (
/turf/open/misc/asteroid/airless,
/area/ruin/space)
"aU" = (
/obj/effect/decal/remains/human,
/obj/item/paper/fluff/ruins/clericsden/warning,
/turf/open/misc/asteroid/airless,
/area/ruin/unpowered/no_grav)
"aV" = (
/obj/effect/decal/cleanable/blood/drip,
/turf/open/misc/asteroid/airless,
/area/ruin/space)
"aW" = (
/turf/closed/mineral/random,
/area/ruin/space)
"aX" = (
/turf/closed/wall,
/area/ruin/space)
"aY" = (
/obj/effect/decal/remains/human,
/obj/item/paper/fluff/ruins/clericsden/warning,
/turf/open/misc/asteroid/airless,
/area/ruin/space)
"aZ" = (
/turf/closed/wall/rust,
/area/ruin/space)
"cs" = (
/obj/effect/decal/cleanable/blood/drip,
/turf/open/floor/carpet/airless,
/area/ruin/space)
"di" = (
/obj/effect/decal/cleanable/blood/tracks,
/obj/machinery/door/airlock/wood,
/turf/open/floor/plating/airless,
/area/ruin/space)
"gi" = (
/obj/structure/rack,
/obj/item/tank/internals/emergency_oxygen,
/obj/item/clothing/mask/breath,
/turf/open/floor/iron/dark/airless,
/area/ruin/space)
"hf" = (
/turf/open/floor/carpet/royalblack/airless,
/area/ruin/space)
"jU" = (
/obj/structure/bonfire,
/turf/open/floor/iron/dark/airless,
/area/ruin/space)
"oE" = (
/obj/structure/light_prism,
/turf/open/floor/iron/dark/airless,
/area/ruin/space)
"pe" = (
/obj/effect/decal/cleanable/blood/tracks,
/obj/structure/trap/cult,
/turf/open/floor/carpet/airless,
/area/ruin/space)
"qe" = (
/obj/effect/decal/cleanable/shreds,
/turf/open/floor/carpet/airless,
/area/ruin/space)
"qx" = (
/obj/effect/decal/cleanable/blood/drip,
/turf/open/floor/carpet/royalblack/airless,
/area/ruin/space)
"rA" = (
/obj/effect/decal/cleanable/shreds,
/obj/effect/decal/remains/human,
/obj/item/disk/design_disk/adv/cleric_mace,
/obj/structure/trap/cult,
/turf/open/floor/carpet/airless,
/area/ruin/space)
"rK" = (
/obj/structure/table/wood/fancy,
/obj/item/reagent_containers/cup/glass/bottle/holywater,
/turf/open/floor/carpet/airless,
/area/ruin/space)
"tP" = (
/obj/structure/closet/crate/coffin,
/turf/open/floor/iron/dark/airless,
/area/ruin/space)
"vu" = (
/obj/item/flashlight/flare/torch,
/turf/open/floor/plating/airless,
/area/ruin/space)
"vN" = (
/obj/effect/spawner/structure/window,
/turf/open/floor/plating/airless,
/area/ruin/space)
"wQ" = (
/obj/item/stack/rods{
	amount = 2
	},
/obj/item/shard,
/turf/open/misc/asteroid/airless,
/area/ruin/space)
"xA" = (
/obj/effect/decal/cleanable/blood/tracks,
/turf/open/floor/carpet/airless,
/area/ruin/space)
"zF" = (
/obj/structure/table/wood{
	layer = 3.3
	},
/turf/open/floor/carpet/royalblack/airless,
/area/ruin/space)
"Ds" = (
/obj/effect/spawner/structure/window,
/obj/structure/barricade/wooden/crude,
/turf/open/floor/plating/airless,
/area/ruin/space)
"Es" = (
/obj/effect/decal/cleanable/blood/splatter,
/obj/effect/decal/cleanable/blood/footprints,
/obj/effect/decal/cleanable/shreds,
/turf/open/floor/carpet/airless,
/area/ruin/space)
"GB" = (
/obj/structure/chair/wood{
	dir = 1
	},
/turf/open/floor/carpet/royalblue/airless,
/area/ruin/space)
"IH" = (
/obj/effect/decal/cleanable/blood/footprints,
/obj/effect/decal/cleanable/blood/tracks,
/turf/open/floor/carpet/airless,
/area/ruin/space)
"Jd" = (
/turf/open/floor/carpet/airless,
/area/ruin/space)
"Jg" = (
/obj/item/ectoplasm,
/turf/open/misc/asteroid/airless,
/area/ruin/space)
"JU" = (
/obj/item/paper/fluff/ruins/clericsden/contact,
/turf/open/floor/plating/airless,
/area/ruin/space)
"Le" = (
/obj/effect/decal/cleanable/shreds,
/turf/open/floor/carpet/royalblack/airless,
/area/ruin/space)
"Ns" = (
/turf/open/floor/carpet/royalblue/airless,
/area/ruin/space)
"Os" = (
/mob/living/simple_animal/hostile/construct/proteon,
/turf/open/misc/asteroid/airless,
/area/ruin/space)
"Ox" = (
/turf/open/floor/plating/airless,
/area/ruin/space)
"PS" = (
/obj/structure/grille/broken,
/obj/structure/barricade/wooden/crude,
/obj/structure/trap/cult,
/obj/effect/decal/cleanable/glass,
/turf/open/floor/plating/airless,
/area/ruin/space)
"RE" = (
/obj/effect/decal/cleanable/blood/drip,
/turf/open/floor/plating/airless,
/area/ruin/space)
"Sm" = (
/obj/structure/table/wood/fancy,
/obj/item/melee/cleric_mace,
/turf/open/floor/carpet/airless,
/area/ruin/space)
"SV" = (
/obj/structure/light_prism,
/turf/open/floor/plating/airless,
/area/ruin/space)
"VF" = (
/obj/effect/spawner/structure/window,
/turf/open/floor/plating,
/area/ruin/space)
"WT" = (
/obj/effect/decal/remains/human,
/obj/structure/trap/cult,
/turf/open/floor/carpet/airless,
/area/ruin/space)
"Xc" = (
/obj/item/book/bible,
/obj/effect/decal/cleanable/blood,
/turf/open/misc/asteroid/airless,
/area/ruin/space)
"XM" = (
/obj/structure/closet/crate/coffin,
/obj/item/gps/spaceruin,
/turf/open/floor/iron/dark/airless,
/area/ruin/space)
"ZO" = (
/obj/effect/decal/cleanable/blood/tracks,
/mob/living/simple_animal/hostile/construct/proteon/hostile,
/turf/open/floor/carpet/airless,
/area/ruin/space)

(1,1,1) = {"
aa
aa
aa
aa
aa
aa
aa
aa
aT
aW
aT
aT
aT
aT
aa
aa
aa
aa
"}
(2,1,1) = {"
aa
aa
aa
aT
aT
aT
aT
aT
aT
aT
aT
aW
aT
aT
aW
aT
aT
aa
"}
(3,1,1) = {"
aa
aT
aW
aT
aT
aW
aT
aW
aT
aT
aW
aW
aW
aT
aW
aW
aW
aa
"}
(4,1,1) = {"
aa
aW
aW
aW
aW
aW
aW
aW
aW
aW
aW
aW
aW
aW
aW
aW
aT
aa
"}
(5,1,1) = {"
aa
aW
aX
aX
aZ
aX
aZ
vN
aX
aX
aX
aX
aX
aX
aZ
aT
aT
aa
"}
(6,1,1) = {"
aa
aW
aZ
oE
XM
aZ
jU
Ox
aZ
jU
Ox
aZ
Ox
gi
aX
aZ
aW
aa
"}
(7,1,1) = {"
aa
aa
aZ
RE
hf
hf
Ns
qx
zF
GB
hf
zF
GB
hf
SV
aZ
aX
aa
"}
(8,1,1) = {"
aa
wQ
PS
Ox
rK
qe
Jd
Jd
Jd
WT
Jd
Jd
Jd
Jd
cs
aP
aT
aT
"}
(9,1,1) = {"
aa
aW
VF
Ox
Sm
rA
Es
xA
IH
ZO
IH
xA
IH
pe
IH
di
aY
aV
"}
(10,1,1) = {"
aa
aW
aX
Ox
hf
Le
Ns
hf
zF
GB
hf
zF
GB
hf
SV
aX
aZ
aT
"}
(11,1,1) = {"
aa
aT
aZ
oE
tP
aX
jU
JU
aZ
jU
vu
aZ
Ox
gi
aZ
aX
aW
aW
"}
(12,1,1) = {"
aa
aa
aZ
aZ
aX
aX
aZ
Ds
aX
aX
aX
aZ
aZ
aX
aX
aW
aW
aT
"}
(13,1,1) = {"
aa
aW
aW
aW
aW
aW
aW
aW
aW
aW
aW
aW
aW
aW
aW
aW
aT
aT
"}
(14,1,1) = {"
aa
aT
aW
aW
aW
aT
aW
aW
aT
aW
aT
Xc
aW
aW
aW
aT
aV
aa
"}
(15,1,1) = {"
aa
aa
aT
aT
aT
aT
aT
aT
Os
aT
aT
aT
aT
aV
aT
aT
aa
aa
"}
(16,1,1) = {"
aa
aa
Jg
aT
aW
aW
aT
aT
aW
aT
aT
aW
aT
aW
aW
aW
aa
aa
"}
(17,1,1) = {"
aa
aW
aT
aW
aT
aW
aW
aW
aW
aW
aW
aW
aW
aW
aT
aa
aa
aa
"}
(18,1,1) = {"
aW
aW
aW
aa
aa
aT
aT
aT
aT
aT
aT
aT
aT
aa
aa
aa
aa
aa
"}
(19,1,1) = {"
aa
aW
aa
aa
aa
aa
aa
aa
aa
aa
aa
aa
aa
aa
aa
aa
aa
aa
"}
